NO ./texture/colorstone.xpm

SO ./texture/mossy.xpm

WE ./texture/redbrick.xpm

EA ./texture/wood.xpm

S ./texture/ererv.xpm

C 256,255,204

F 51,51,51

R 1400 800

     1111111111111111111111111
     1000000000110000000000001
     1011000001110000000000001
     1001000000000000000000001
111111101011000001110000000000111
100000000000000001110111111111111
11110111111111010000000000001
11110111111111011101010000001
11000000110101011100000000001
10000200000000001100000010001
10000000000000001101010010001
11000001110101011111011110N01
11110111 1110101 100000010001
11111111 1111111 111111111111
